NO ./assets/textures/north.png
SO ./assets/textures/south.png
WE ./assets/textures/west.png
EA ./assets/textures/east.png
F 300,100,0
C 225,30,0

1111111111
1000000001
1001N00101
1111111111
