NO ./assets/textures/north.png
SO ./assets/textures/south.png
WE ./assets/textures/west.png
EA ./assets/textures/east.png
F 220,100,0
C 225,30,0

1111111111
1N0000000N
1000000001
1111111111
