NO ./assets/wall/north.png
SO ./assets/wall/south.png
WE ./assets/wall/west.png
EA ./assets/wall/east.png

F 220,100,0
C 225,30,0

1111111111
1N00000001
10000000N1
1111111111
