NO ./assets/textures/north.png
SO ./assets/textures/south.png
WE ./assets/textures/west.png
EA ./assets/textures/east.png

C 135,206,235
F 34,139,34

111111111111111111111111111
1  111111            1
1  1S0001            1
111101111            1
11000111111111111111111
110111     11111111111
110111     10000011111
11011111111110111011111
11000000000000010101111
11111111111111010101111
11111111111110101011111
11111111111111011101001111111
11111110000000000000000000111
111111101111111000000000000011
111111101111110100001111111111
111111111111111100001111
11111111111111111111111